START TABLE: system_config
START METADATA:
table_name	field_name	is_identity	user_type_id	type_name	precision
SYSTEM_CONFIG	ATTRIBUTE_NAME	0	231	nvarchar	0
SYSTEM_CONFIG	ATTRIBUTE_VALUE	0	231	nvarchar	0
END METADATA:
START DATA:
ATTRIBUTE_NAME	ATTRIBUTE_VALUE
site_name	PC-AS1611
site_locn	PC-AS1611
server_host	mar-rhel5-dev
def_ph_report	3600
op_upload_flag	F
db_version	Database Version 8.7
cim_version	8.7.0.0
fm_version	NULL
build_num
epv_version	NULL
maint_tagging	F
plant_host_flags	TTTTTTTTTTTTTTTTTTTT
op_delete_flag	F
shared_cim_routes	F
force_patt_per_panel	F
minimal_lm	F
validate_cvt_logins	F
unmount_unused_trays	F
state_model	0
enable_pmd_monitor	T
enable_event_history	F
enable_state_history	T
spl_aq_apps_disabled	F
keep_fdrs_loaded	F
purge_dir	E:\Backup.DB\archive
db_retain_time	60
db_retain_size_gb	8
cs_alert_distance_mm	1200
space_check_time	03:00
preferred_purge_day	0
immediate_purge_req	3
preferred_purge_req	14
no_of_rec_for_comp	10
purge_no_of_days	7
retain_no_of_extents	1
max_no_of_days_data	60
rep_hist_retain_days	60
create_purge_file	T
database_size_alert_gb	20
trans_log_size_alert_gb	10
empty_exhausted_reel	T
empty_msd_exp_reel	F
mes_server_host	NULL
reuse_reel_barcodes	F
reuse_reel_validate	0
refuse_new_material	F
transfer_logging	F
initial_trans_login	T
all_trans_login	F
downtime_login	F
record_job_number	F
record_job_quantity	F
one_one_job_prod	T
one_many_job_prod	F
enable_shift_view	F
cimc_auto_gen_wo	F
expiration_email_to	NULL
exp_email_before	NULL
notify_lic_exp	F
first_day_of_week	0
first_week_of_year	0
cs_enabled	F
cs_enable_notice	F
cs_threshold_type	0
cs_alert_level1	10
cs_alert_level2	0
cs_use_pitch_alerts	F
cs_alert_dist_mm	1200
cs_pitch_alert_type	1
cs_level1_action	NULL
cs_level1_params	NULL
cs_level2_action	NULL
cs_level2_params	NULL
cs_exhaust_action	NULL
cs_exhaust_params	NULL
cs_picked_action	NULL
cs_picked_params	NULL
cs_dep_enable	F
cs_dep_thresh_value	5
dependent_fdr_flag	F
cvt_change_location	S
rest_comp_mode	0
merge_tapesplice_qty	F
pt_mach_flag	T
pt_aw_flag	T
pt_cvt_flag	T
pt_download_flag	T
pt_select_flag	F
pt_adjust_flag	F
inc_neg_scrap_value	F
forc_cmpl_tray_setup	F
enable_gen_bc_scan	F
confirm_unmatch_bc	F
enable_base_prod_dtl	F
disp_bom_prefix	F
disp_base_prod_name	F
special_aoi_flag	F
panel_hold_start_log	F
panel_hold_end_log	F
wo_change_logging	F
wo_session_logging	T
wo_all_change_loggin	F
auto_gen_work_order	F
auto_close_wo_on_qty	F
enable_deviat_part	F
lock_type_setupaudit	T
lock_type_expiredmsd	T
lock_type_trace	F
pa_data_trace	F
lock_type_tagged_fdr	F
lock_type_3rd_party	T
lock_type_invalidcmp	T
lock_type_invsetup	F
use_master_wo	F
num_days_wo_limit	30
is_new_PA_enabled	T
is_new_reports_enabled	T
is_DW_enabled	F
is_RDB_enabled	F
is_pa_templates_enabled	F
is_downtime_schedule_enabled	T
is_pa_display_legend_abbr	F
or_alert_limit	0.000000
boards_produced_alert_limit	0.000000
scrap_alert_limit	0.000000
placement_alert_limit	0.000000
pickup_alert_limit	0.000000
rdb_db_name	NULL
rdb_server	NULL
rdb_server_port	-1
OLAP_LinkServer	F
controller_guid	NULL
controller_id	-1
is_prod_alerts_enabled	T
panacim_server_type	1
import_vibratory_fdr	T
dynamic_model_adjust	F
panapro_server	NULL
panapro_uid	PROADMIN
panapro_pass	PROSUCCESS
dgs_integration	F
plan_availability_rate	90
plan_performance_rate	95
plan_quality_rate	99.99
npm_pushless_feeder	F
intl_supply_prog_mod	0
custom_area_3_cont	1
pac_processing	F
pac_source	0
pac_extra_item	0
pac_extra_result	0
splice_miss_lck_prct	0
publish_enable	F
publish_location	NULL
publish_username	NULL
publish_password	NULL
publish_prefix	NULL
publish_site_id	NULL
physical_site_id	e3b5551b-c830-470d-9a8e-f38434f499a8
physical_site_name	PC-AS1611__e3b5551b-c830-470d-9a8e-f38434f499a8
master_install_site	T
super_admin_password	_p97WtAde5ko2
user_data_label1	user_data_name
user_data_label2	user_data_2_name
user_data_label3	user_data_3_name
user_data_label4	user_data_4_name
user_data_label5	user_data_5_name
paste_chlk_enabled	F
paste_check_pcb	0
paste_lock_pcb	0
cimc_os	Red Hat Enterprise Linux Server release 5.2 (Tikanga)
mr_mtrl_prefix_type	0
mr_mtrl_prefix
mr_use_splr_part_map	F
mr_splr_part_per_map	1
mr_use_exst_sup_part	F
lock_type_pana_exhaust	F
exclude_lunch_break	F
exclude_other_break	F
allow_event_extension	F
peer_initialized	F
peer_sync_enabled	F
peer_elink_unc	\\\\\\\\IPC_name\TraceFiles
peer_sync_interval	5
peer_server_seed	5000
ss_pushless_feeder	F
wo_data_source_enable	F
wo_username	NULL
wo_password	NULL
bom_file_location	NULL
bom_username	NULL
bom_password	NULL
lock_type_skip_location	T
allow_splice_at_part_exhaust	F
use_extended_reel_qty	T
npm_pmd_special	F
pac_mid_restrict_location	F
active_debug_duration	120
lnb_scanner_parts_events	F
enable_trays_setup_audit	T
enable_led_bcp	F
lock_type_invalid_led_config	T
lock_type_led_part_gridlock	T
enable_manual_audit_startup_cnf	F
force_operator_verify	F
enable_lcr_support	F
lcr_auto_verify_delay	0
use_lcr_regex	T
use_material_market_usages	F
mr_validate_part_no	F
integrate_mms	F
mms_base_address	http://
psne_optimization_cycle	300
psne_optimization_in_desig_hour	10800
psne_travel_order_fixed_no	10
psne_pe_work_priority_time	600
psne_tray_travel_order_enabled	F
lnb_inline_shelf_management_enabled	F
psne_def_su_work_time	180
psne_def_part_supply_feeder_time	120
psne_def_part_supply_tray_time	180
pac_processing_panasert	F
al_fdr_support	F
al_fdr_shutter_ctrl	F
enable_checksum_ccs_scanner_upgrade	F
system_backup_time	02:00 PM
enable_custom_substitute_format_support	F
enable_ss_fdr_for_cm_presetup	F
show_part_polarity	F
toggle_work_area_icon	F
hide_show_all_feeders	F
part_scan_setup_audit_quick_switch	F
enable_link_work_order	F
enable_quality_data_pa_factory_production	F
pcc_auto_assign_model_string	F
newpmd_timer_refresh	15000
enable_nozzle_maintenance	F
wo_file_location	NULL
enable_bulk_reservation	F
keep_future_wo_reservation	F
is_pa_route_prod_temp_enabled	F
enable_npm_cycle_time_from_lnb	F
dt_upload_password	NULL
dt_download_password	NULL
lock_type_inaccessible_file_shares	F
enable_location_verification	F
lnb_ccsi_port	4104
launch_pad_export_path	C:\Inetpub\wwwroot\ePlantView\SavedFiles
enable_board_barcode_converter	F
mr_with_op_privilege	F
cm_cycle_time	0
npm_cycle_time	0
ccs_pmd_language_id	0
END DATA:
END TABLE: system_config
